###############
#f #         f#
#  ##  ####   #
#        #    #
#  #     # ## #
#  #       #  #
# ##  ###     #
#  ## #p#     #
#  ## # #     #
## #       #  #
#  #     # ## #
#        #    #
#  ##  ####   #
#f #          #
###############