###############
#  #          #
#  #       #  #
## #       #  #
#  # ## ## ## #
#  # #   #    #
#             #
## # #   #    #
#  # ## ##    #
#  #  # #     #
# ##  # # ## ##
#  ## # ###   #
#         #   #
#  #          #
###############