###############
#             #
# ## ## ## ## #
# ## ## ## ## #
#             #
# ## ##### ## #
# #    #    # #
# #    #    # #
#   ##   ##   #
# # ##   ## # #
# #    #    # #
# #    #    # #
# ## ##### ## #
#             #
###############